###############
#.............#
#.............#
#.............#
#.............#
#.............#
#########.#####
#..........#...
#..........#...
#..........#...
#..........#...
#..........#...
#..............
############...
